#domain
hospital
#levelname
SAD1
#colors
blue: 0, A
red: 1
#initial
+++++++++++++
+   +++     +
+++++ +++++++
+0A1        +
+++++++++++++
#goal
+++++++++++++
+   +++     +
+++++ +++++++
+1         A+
+++++++++++++
#end
