#domain
hospital
#levelname
SEQ_CBS_1
#colors
blue: 0, A
green: Z
#initial
++++++++++
+0       +
+        +
+AZ      +
+ Z      +
++++++++++
#goal
++++++++++
+        +
+        +
+        +
+A       +
++++++++++
#end
