#domain
hospital
#levelname
SAD1
#colors
blue: 0, A
red: 1, B
#initial
+++++++++++++++++++
+0A               +
+              ++++
+    1B           +
+              ++ +
+               + +
+++++++++++++++++++
#goal
+++++++++++++++++++
+                 +
+              ++++
+                 +
+              ++B+
+               +A+
+++++++++++++++++++
#end
