#domain
hospital
#levelname
corridors
#colors
red: 0, T
#initial
+++++++++++++++++++++++
+0                    +
+                 T   +
+++++++++++++++++++++++
#goal
+++++++++++++++++++++++
+             T       +
+                    0+
+++++++++++++++++++++++
#end